#####################################################################################
#####################################################################################
#####################################################################################
#####################################################################################
#####################################################################################
#####################################################################################
#                                             @                                     #
# #########################     ######################## ######################     #
#                                                                   $               #
# ################ ####################### ########################### ############ #
#                                                                                   #
# ####################  ##################  #################### ################## #
#                                                                                   #
#####################################################################################
#####################################################################################